26
12
1 0 0 0 0 0 0 0 0 0 0 0 0 0 0 0 0 0 0 0 0 0 0 0 0 2
6 3 3 3 0 0 0 0 0 0 0 0 0 0 0 0 0 0 0 0 0 0 3 3 3 6
7 11 11 11 0 0 0 0 0 0 0 8 9 9 10 0 0 0 0 0 0 0 11 11 11 7
7 0 0 0 0 0 0 0 0 0 0 0 0 0 0 0 0 0 0 0 0 0 0 0 0 7
7 3 3 0 0 0 0 8 10 0 0 0 0 0 0 0 0 8 10 0 0 0 0 3 3 7
7 11 11 0 0 0 0 0 0 0 0 0 0 0 0 0 0 0 0 0 0 0 0 11 11 7
7 0 0 0 0 0 0 0 0 0 0 7 8 8 9 0 0 0 0 0 0 0 0 0 1 7
7 6 0 0 0 0 0 0 0 0 0 0 0 0 0 0 0 0 0 0 0 0 0 0 6 7
7 7 0 0 0 0 8 9 10 0 0 0 0 0 0 0 0 8 9 10 0 0 0 0 7 7
7 7 6 0 0 0 0 0 0 0 0 0 0 0 0 0 0 0 0 0 0 0 0 6 7 7
7 7 7 0 0 0 0 0 0 0 0 0 0 0 0 0 0 0 0 0 0 0 0 7 7 7
7 7 7 6 6 0 0 6 6 6 6 6 0 0 6 6 6 6 6 0 0 6 6 6 6 7